barb	B AA R B
ralph	R AE L F
ingredients	IH N G R IY D IY AH N T S
time	T AY M
subway	S AH B W EY
materials	M AH T IH R IY AH L Z
slope	S L OW P
objects	AH B JH EH K T S
right	R AY T
these	TH IY S
intelligence	IH N T EH L AH JH AH N S
contagious	K AH N T EY JH AH S
timber	T IH M B ER
answer	AE N S ER
few	F Y UW
project	P R AA JH EH K T
pocket	P AA K AH T
authorities	AH TH AO R AH T IY Z
lines	L AY N Z
annoying	AH N OY IH NG
each	IY CH
big	B IH G
audits	AO D IH T S
prospect	P R AA S P EH K T
made	M EY D
john	JH AA N
butcher	B UH CH ER
greg	G R EH G
seattle	S IY AE T AH L
guard	G AA R D
ropes	R OW P S
experts	EH K S P ER T S
a	AH
increasing	IH N K R IY S IH NG
cutting	K AH T IH NG
enjoy	EH N JH OY
morning	M AO R N IH NG
smiles	S M AY L Z
i	AY
situated	S IH CH UW EY T IH D
new	N UW
red	R EH D
conformists	K AH N F AO R M AH S T S
elegant	EH L AH G AH N T
guess	G EH S
having	HH AE V IH NG
medieval	M IH D Y IY V AH L
unevenly	AH N IY V AH N L IY
strongly	S T R AO NG L IY
fancy	F AE N S IY
bob	B AA B
drop	D R AA P
change	CH EY N JH
distributed	D IH S T R IH B Y UW T IH D
silverware	S IH L V ER W EH R
bog	B AA G
has	HH AE Z
medical	M EH D IH K AH L
papered	P EY P ER D
processing	P R AA S EH S IH NG
synagogue	S IH N AH G AO G
had	HH AE D
hook	HH UH K
rationalize	R AE SH N AH L AY Z
scared	S K EH R D
overalls	OW V ER AO L Z
fan	F AE N
much	M AH CH
borrow	B AA R OW
cream	K R IY M
rural	R UH R AH L
particularly	P ER T IH K Y AH L ER L IY
items	AY T AH M Z
often	AO F AH N
frantically	F R AE N AH K L IY
healthier	HH EH L TH IY ER
areas	EH R IY AH S
day	D EY
fast	F AE S T
make	M EY K
leap	L IY P
large	L AA R JH
room	R UW M
schnooks	SH N UH K S
through	TH R UW
generous	JH EH N ER AH S
business	B IH Z N AH S
completely	K AH M P L IY T L IY
glistened	G L IH S AH N D
farm	F AA R M
lights	L AY T S
dime	D AY M
balls	B AO L Z
possible	P AA S AH B AH L
paw	P AO
lori's	L AO R IH S
lessons	L EH S AH N Z
welcomed	W EH L K AH M D
laboratory	L AE B R AH T AO R IY
sketched	S K EH CH T
centrifuge	S EH N T R AH F Y UW JH
planned	P L AE N D
pam	P AE M
never	N EH V ER
great	G R EY T
which	W IH CH
nuclear	N UW K L IY ER
pewter	P Y UW T ER
take	T EY K
there	DH EH R
brown	B R AW N
box	B AA K S
boy	B OY
calcium	K AE L S IY AH M
lower	L OW ER
filtering	F IH L T ER IH NG
glow	G L OW
honey	HH AH N IY
help	HH EH L P
errors	EH R ER Z
social	S OW SH AH L
bones	B OW N Z
visually	V IH ZH W AH L IY
her	HH ER
consists	K AH N S IH S T S
carry	K AE R IY
identify	AY D EH N T AH F AY
job	JH AA B
slapped	S L AE P T
rob	R AA B
perfume	P ER F Y UW M
will	W IH L
upon	AH P AA N
newspaper	N UW Z P EY P ER
shore	SH AO R
indeed	IH N D IY D
home	HH OW M
roam	R OW M
costumes	K AA S T UW M Z
assistance	AH S IH S T AH N S
thought	TH AO T
holidays	HH AA L AH D EY Z
tablecloths	T EY B AH L K L AO TH S
short	SH AO R T
distance	D IH S T AH N S
simpler	S IH M P L ER
magnetism	M AE G N AH T IH Z AH M
rather	R AE DH ER
products	P R AA D AH K T S
dozen	D AH Z AH N
beautiful	B Y UW T AH F AH L
surprisingly	S ER P R AY Z IH NG L IY
stopwatch	S T AA P W AA CH
misquote	M IH S K W OW T
dishes	D IH SH IH Z
mustache	M AH S T AE SH
freeway	F R IY W EY
props	P R AA P S
single	S IH NG G AH L
oriental	AO R IY EH N T AH L
contains	K AH N T EY N Z
him	HH IH M
every	EH V R IY
where	W EH R
eight	EY T
related	R IY L EY T IH D
his	HH IH S
rare	R EH R
january	JH AE N Y UW EH R IY
useful	Y UW S F AH L
beg	B EH G
here	HH IH R
accusations	AE K Y AH Z EY SH AH N Z
jennifer's	JH EH N AH F ER Z
requires	R IY K W AY ER Z
lentils	L EH N T AH L Z
strong	S T R AO NG
antelope	AE N T AH L OW P
streets	S T R IY T S
shampooed	SH AE M P UW D
quick	K W IH K
while	W AY L
skirts	S K ER T S
vocabulary	V OW K AE B Y AH L EH R IY
gives	G IH V Z
task	T AE S K
your	Y AO R
parenthood	P EH R AH N T HH UH D
into	IH N T OW
sport	S P AO R T
problem	P R AA B L AH M
past	P AE S T
buys	B AY Z
cleans	K L IY N Z
convenient	K AH N V IY N Y AH N T
meow	M IY AW
looked	L UH K T
thursdays	TH ER Z D EY Z
ears	IH R Z
earn	ER N
changes	CH EY N JH IH Z
sugar	SH UH G ER
understand	AH N D ER S T AE N D
matched	M AE CH T
inevitable	IH N EH V AH T AH B AH L
treatment	T R IY T M AH N T
nice	N AY S
yellow	Y EH L OW
its	IH T S
garbage	G AA R B IH JH
customer	K AH S T AH M ER
eyes	AY Z
halloween	HH AE L AH W IY N
streamlined	S T R IY M L AY N D
thighs	TH AY Z
interest	IH N T R AH S T
year	Y IH R
along	AH L AO NG
radiosterilization	R EY D IY OW S T EH R AH L IH Z EY SH AH N
cook	K UH K
laugh	L AE F
swedish	S W IY D IH SH
miami	M AY AE M IY
under	AH N D ER
always	AE L W EY Z
mergers	M ER JH ER Z
system	S IH S T AH M
lot	L AA T
favor	F EY V ER
magnetic	M AE G N EH T IH K
cheap	CH IY P
rug	R AH G
grazing	G R EY Z IH NG
use	Y UW S
expensive	IH K S P EH N S IH V
unlimited	AH N L IH M IH T IH D
run	R AH N
american	AH M EH R AH K AH N
electron	IH L EH K T R AA N
best	B EH S T
pick	P IH K
we'll	W EH L
harmonize	HH AA R M AH N AY Z
come	K AH M
back	B AE K
young	Y AH NG
gave	G EY V
feeling	F IY L IH NG
kindergarten	K IH N D ER G AA R T AH N
hierarchies	HH AY R AA R K IY Z
straw	S T R AO
become	B IH K AH M
fairy	F EH R IY
good	G UH D
stray	S T R EY
ended	EH N D AH D
appetizers	AE P AH T AY Z ER Z
must	M AH S T
auditors	AO D IH T ER Z
robin	R AA B AH N
curious	K Y UH R IY AH S
lunch	L AH N CH
causeway	K AO Z W EY
burned	B ER N D
control	K AH N T R OW L
gone	G AO N
economic	EH K AH N AA M IH K
december	D IH S EH M B ER
weatherproof	W EH DH ER P R UW F
sound	S AW N D
argued	AA R G Y UW D
several	S EH V ER AH L
case	K EY S
burn	B ER N
scarf	S K AA R F
walking	W AO K IH NG
gallon	G AE L AH N
can	K AH N
subsystems	S AH B S IH S T AH M Z
children	CH IH L D R AH N
cory	K AO R IY
dirty	D ER T IY
unusual	AH N Y UW ZH AH W AH L
question	K W EH S CH AH N
meats	M IY T S
strength	S T R EH NG K TH
approval	AH P R UW V AH L
you	Y UW
arboreal	AA R B ER IY AH L
soon	S UW N
general	JH EH N ER AH L
unit	Y UW N IH T
classrooms	K L AE S R UW M Z
charge	CH AA R JH
anything	EH N IY TH IH NG
high	HH AY
somewhat	S AH M W AH T
wear	W EH R
very	V ER IY
birth	B ER TH
surface	S ER F AH S
feels	F IY L Z
house	HH AW S
leaves	L IY V Z
people	P IY P AH L
beyond	B IH AA N D
hostages	HH AA S T IH JH IH Z
avoid	AH V OY D
candy	K AE N D IY
milk	M IH L K
income	IH N K AH M
yourself	Y UH R S EH L F
industry	IH N D AH S T R IY
working	W ER K IH NG
bleachers	B L IY CH ER Z
spending	S P EH N D IH NG
extra	IH K S T R AH
goat	G OW T
hours	AW ER Z
generals	JH EH N ER AH L Z
like	L AY K
teeth	T IY TH
huge	HH Y UW JH
not	N AA T
many	M AH N IY
marvelously	M AA R V AH L AH S L IY
haven't	HH AE V AH N T
sat	S AE T
now	N AW
say	S EY
buff	B AH F
saw	S AO
years	Y IH R Z
some	S AH M
dance	D AE N S
put	P UH T
murals	M Y UH R AH L Z
grows	G R OW Z
block	B L AA K
boat's	B OW T S
pill	P IH L
mine	M AY N
paramagnetic	P EH R AH M AE G N EH T IH K
slowly	S L OW L IY
prospective	P R AA S P EH K T IH V
phony	F AH N IY
authorized	AO TH ER AY Z D
stranded	S T R AE N D IH D
ball	B AO L
slash	S L AE SH
cases	K EY S IH Z
return	R IY T ER N
excited	IH K S AY T AH D
chair	CH EH R
lily	L IH L IY
beggar	B EH G ER
bungalow	B AH NG G AH L OW
folded	F OW L D IH D
but	B AH T
latent	L EY T AH N T
buy	B AY
structural	S T R AH K CH ER AH L
beach	B IY CH
remote	R IY M OW T
together	T AH G EH DH ER
upbringing	AH P B R IH NG IH NG
swing	S W IH NG
chief	CH IY F
petticoats	P EH T IY K OW T S
carriage	K AE R IH JH
bonfire	B AA N F AY ER
knows	N OW Z
yell	Y EH L
thick	TH IH K
sing	S IH NG
diagram	D AY AH G R AE M
exposure	IH K S P OW ZH ER
jane	JH EY N
call	K AO L
paper	P EY P ER
aches	EY K S
upper	AH P ER
increases	IH N K R IY S IH Z
tradition	T R AH D IH SH AH N
sprained	S P R EY N D
oasis	OW EY S IH S
hurts	HH ER T S
pressure	P R EH SH ER
poor	P UH R
came	K EY M
grandmother	G R AE M AH DH ER
soft	S AO F T
around	ER AW N D
noise	N OY Z
address	AH D R EH S
target	T AA R G AH T
costume	K AA S T UW M
rifle	R AY F AH L
special	S P EH SH AH L
their	DH EH R
first	F ER S T
lie	L IY
formula	F AO R M Y AH L AH
need	N IY D
blouses	B L AW S IH Z
said	S EY D
fish	F IH SH
higher	HH AY ER
jeff	JH EH F
father's	F AA DH ER Z
politics	P AA L AH T IH K S
over	OW V ER
began	B IH G AE N
she	SH IY
boring	B AO R IH NG
spider	S P AY D ER
partner	P AA R T N ER
slow	S L OW
black	B L AE K
once	AA N S
effects	IH F EH K T S
he	HH IY
alice's	AE L AH S AH Z
further	F ER DH ER
entertaining	EH N ER T EY N IH NG
eat	IY T
adventures	AE D V EH N CH ER Z
artificial	AA R T AH F IH SH AH L
review	R IY V Y UW
go	G OW
needlepoint	N IY D AH L P OY N T
before	B IH F AO R
speculations	S P EH K Y AH L EY SH AH N Z
oil	OY L
extensive	IH K S T EH N S IH V
guns	G AH N Z
wage	W EY JH
coleslaw	K OW L S L AA
do	D OW
prevented	P R IY V EH N T IH D
look	L UH K
skirt	S K ER T
may	M EY
organizations	AO R G AH N AH Z EY SH AH N Z
web	W EH B
whatsoever	HH W AH T S OW EH V ER
living	L IH V IH NG
negotiations	N IH G OW SH IY EY SH AH N Z
what	W AH T
elderly	EH L D ER L IY
yet	Y EH T
outgrew	AW T G R UW
captured	K AE P CH ER D
driving	D R AY V IH NG
by	B AY
plays	P L EY Z
oldsters	OW L D S T ER Z
enough	IH N AH F
same	S EY M
who	HH UW
endurance	IH N D UH R AH N S
would	W UH D
fleecy	F L IY S IY
autumn	AO T AH M
any	EH N IY
gloom	G L UW M
be	B IY
occasionally	AH K EY ZH N AH L IY
get	G EH T
unstuck	AH N S T AH K
umbrella	AH M B R EH L AH
superb	S UW P ER B
learn	L ER N
rector	R EH K T ER
apology	AH P AA L AH JH IY
breakdown	B R EY K D AW N
mopped	M AA P T
forces	F AO R S IH Z
bedroom	B EH D R UW M
and	AH N D
near	N IH R
i'd	IH D
played	P L EY D
tooth	T UW TH
wall	W AO L
nihilistic	N AY AH L IH S T IH K
flies	F L AY Z
mobile	M OW B AH L
thing	TH IH NG
garage	G ER AA ZH
purchase	P ER CH AH S
chosen	CH OW Z AH N
stole	S T OW L
stockings	S T AA K IH NG Z
treats	T R IY T S
bargains	B AA R G AH N Z
carrying	K EH R IY IH NG
woolen	W UH L AH N
wake	W EY K
experience	IH K S P IH R IY AH N S
pond	P AA N D
all	AO L
flimsy	F L IH M Z IY
five	F AY V
society	S AH S AY AH T IY
makes	M EY K S
at	AE T
abdomen	AE B D OW M AH N
as	AH S
message	M EH S IH JH
michael	M AY K AH L
an	AE N
heating	HH IY T IH NG
arrival	ER AY V AH L
approach	AH P R OW CH
geese	G IY S
why	W AY
basketball	B AE S K AH T B AO L
they	DH EY
nobody	N OW B AA D IY
fell	F EH L
employment	IH M P L OY M AH N T
no	N OW
street	S T R IY T
of	AH V
sleepily	S L IY P AH L IY
bread	B R EH D
combine	K AH M B AY N
buyer	B AY ER
on	AA N
only	OW N L IY
rented	R EH N T IH D
miraculously	M ER AE K Y AH L AH S L IY
twelfth	T W EH L F TH
services	S ER V AH S AH Z
or	AO R
cliff	K L IH F
done	D AH N
questions	K W EH S CH AH N Z
soothed	S UW DH D
welfare	W EH L F EH R
galoshes	G AH L AA SH IH Z
prime	P R AY M
gas	G AE S
bounded	B AW N D IH D
them	DH EH M
crayons	K R EY AA N Z
small	S M AO L
novel	N AA V AH L
fashion	F AE SH AH N
radiation	R EY D IY EY SH AH N
development	D IH V EH L AH P M AH N T
most	M OW S T
followed	F AA L OW D
idly	AY D L IY
looking	L UH K IH NG
massage	M AH S AA ZH
solve	S AA L V
shellfish	SH EH L F IH SH
withdraw	W IH DH D R AO
me	M IY
decorate	D EH K ER EY T
larger	L AA R JH ER
don't	D AA N T
it's	IH T S
cleaners	K L IY N ER Z
marriage	M EH R IH JH
my	M AY
product	P R AA D AH K T
musicians	M Y UW Z IH SH AH N Z
item	AY T AH M
account	AH K AW N T
within	W IH TH IH N
approximated	AH P R AA K S AH M EY T IH D
second	S EH K AH N D
sometimes	S AH M T AY M Z
being	B IY IH NG
masks	M AE S K S
carpet	K AA R P AH T
study	S T AH D IY
shirtsleeve	SH ER T S L IY V
military	M IH L AH T EH R IY
love	L AH V
more	M AO R
accomplished	AH K AA M P L IH SH T
age	EY JH
when	W EH N
phrase	F R EY Z
peck	P EH K
investigation	IH N V EH S T AH G EY SH AH N
patiently	P EY SH AH N T L IY
such	S AH CH
controlled	K AH N T R OW L D
this	TH IH S
stick	S T IH K
loss	L AO S
highway	HH AY W EY
catastrophic	K AH T AE S T R OW F IH K
pizzerias	P IY T S ER IY AH Z
potatoes	P AH T EY T OW Z
dome	D OW M
way	W EY
sleeping	S L IY P IH NG
from	F R AH M
add	AE D
was	W AH Z
resides	R IY Z AY D Z
real	R IY L
prestige	P R EH S T IY ZH
if	IH F
seemed	S IY M D
kidnappers	K IH D N AE P ER Z
heave	HH IY V
colored	K AH L ER D
sailors	S EY L ER Z
zoning	Z OW N IH NG
less	L EH S
is	IH S
those	TH OW Z
it	IH T
gets	G EH T S
retracted	R IY T R AE K T AH D
in	IH N
section	S EH K SH AH N
spend	S P EH N D
merit	M EH R AH T
two	T UW
away	AH W EY
electrical	IH L EH K T R IH K AH L
felt	F EH L T
eating	IY T IH NG
spinach	S P IH N AH CH
remained	R IH M EY N D
worry	W ER IY
knowingly	N OW IH NG L IY
slipped	S L IH P T
parental	P AA R EH N T AH L
fences	F EH N S AH Z
received	R IH S IY V D
ready	R EH D IY
aluminum	AH L UW M AH N AH M
forgot	F ER G AA T
serve	S ER V
books	B UH K S
trend	T R EH N D
how	HH AW
untimely	AH N T AY M L IY
twilight	T W AY L AY T
leeway	L IY W EY
roger's	R AA JH ER Z
mom	M AA M
reads	R EH D Z
rubbed	R AH B D
proceeding	P R OW S IY D IH NG
own	OW N
shaving	SH EY V IH NG
exam	IH G Z AE M
we	W IY
common	K AA M AH N
simple	S IH M P AH L
abruptly	AH B R AH P T L IY
tempted	T EH M P T IH D
whenever	HH W EH N EH V ER
hard	HH AA R D
ability	AH B IH L IH T IY
luxurious	L AH G ZH ER IY AH S
arriving	ER AY V IH NG
later	L EY T ER
us	AH S
ambiguous	AE M B IH G Y UW AH S
up	AH P
field	F IY L D
artists	AA R T IH S T S
expense	IH K S P EH N S
modeling	M AA D L IH NG
husbandry	HH AH Z B AH N D R IY
part	P AA R T
to	T UW
astrophysics	AE S T R OW F IH S IH K S
chablis	SH AH B L IY
frost	F R AO S T
after	AE F T ER
mirage	M ER AA ZH
fallen	F AA L AH N
electricity	IH L EH K T R IH S AH T IY
puncturing	P AH NG K CH ER IH NG
however	HH AW EH V ER
so	S OW
white	W AY T
lake	L EY K
palm	P AA M
unpleasant	AH N P L EH Z AH N T
that	DH AE T
bugle	B Y UW G AH L
than	TH AE N
suppers	S AH P ER Z
clumsy	K L AH M Z IY
cigarette	S IH G ER EH T
ambulance	AE M B Y AH L AH N S
cutbacks	K AH T B AE K S
about	AH B AW T
ceramic	S ER AE M IH K
well	W EH L
sun	S AH N
hand	HH AE N D
journal	JH ER N AH L
destroy	D IH S T R OY
barometric	B AE R AH M EH T R IH K
rail	R EY L
dislikes	D IH S L AY K S
too	T UW
popularity	P AA P Y AH L EH R AH T IY
bowl	B OW L
separate	S EH P ER EY T
muscular	M AH S K Y AH L ER
agricultural	AE G R IH K AH L CH ER AH L
needed	N IY D IH D
months	M AH N TH S
nancy's	N AE N S IY Z
grades	G R EY D Z
our	AW ER
brief	B R IY F
out	AW T
countryside	K AH N T R IY S AY D
twitched	T W IH CH T
thursday's	TH ER Z D EY Z
for	F AO R
test	T EH S T
tag	T AE G
tempo	T EH M P OW
rescue	R EH S K Y UW
governor	G AH V ER N ER
supervision	S UW P ER V IH ZH AH N
sympathetically	S IH M P AH TH EH T IH K L IY
are	AA R
excluded	IH K S K L UW D IH D
file	F AY L
overcharged	OW V ER CH AA R JH D
youngsters	Y AH NG S T ER Z
arm	AA R M
refused	R IH F Y UW Z D
problems	P R AA B L AH M Z
others	AH DH ER Z
brochure	B R OW SH UH R
did	D IH D
table	T EY B AH L
without	W IH DH AW T
nightly	N AY T L IY
obtain	AH B T EY N
symbols	S IH M B AH L Z
farmyard	F AA R M Y AA R D
ask	AE S K
position	P AH Z IH SH AH N
cranberry	K R AE N B EH R IY
dew	D UW
pleasantly	P L EH Z AH N T L IY
neglect	N IH G L EH K T
diseases	D IH Z IY Z IH Z
paid	P EY D
cloth	K L AO TH
union	Y UW N Y AH N
money	M AH N IY
wardrobe	W AO R D R OW B
litter	L IH T ER
rent	R EH N T
augmented	AA G M EH N T IH D
boots	B UW T S
gloves	G L AH V Z
ankle	AE NG K AH L
reviewers	R IY V Y UW ER Z
should	SH UH D
cat's	K AE T S
snake	S N EY K
stepladders	S T EH P L AE D ER Z
lunchroom	L AH N CH R UW M
fog	F AA G
based	B EY S T
hated	HH EY T AH D
functional	F AH NG K SH AH N AH L
spilled	S P IH L D
justification	JH AH S T AH F AH K EY SH AH N
fortune	F AO R CH AH N
pulsing	P AH L S IH NG
hats	HH AE T S
audition	AA D IH SH AH N
silly	S IH L IY
were	W ER
please	P L IY Z
charlie's	CH AA R L IY Z
woman	W UH M AH N
diagnosed	D AY AH G N OW S T
work	W ER K
shoes	SH UW Z
worm	W ER M
swarmed	S W AO R M D
worn	W AO R N
eyebrow	AY B R AW
sense	S EH N S
cattle	K AE T AH L
coincided	K OW AH N S AY D AH D
himself	HH IH M S EH L F
promote	P R AH M OW T
popular	P AA P Y AH L ER
even	IY V AH N
wore	W AO R
clay	K L EY
ride	R AY D
noteworthy	N OW T W ER DH IY
warm	W AO R M
allow	AH L AW
have	HH EY V
one	W AH N
pretty	P R IH T IY
dim	D IH M
daphne's	D AE F N IY Z
trish	T R IH SH
protected	P R AH T EH K T IH D
weekday	W IY K D EY
fresh	F R EH SH
ambled	AE M B AH L D
meat	M IY T
die	D AY
mean	M IY N
dig	D IH G
ships	SH IH P S
they're	DH EH R
forms	F AO R M Z
with	W IH TH
crunched	K R AH N CH T
steep	S T IY P
the	DH
nearest	N IH R AH S T
informative	IH N F AO R M AH T IH V
