divorced	D IH V AO R S T
it	IH T
lawyers	L AO Y ER Z
as	AH S
him	HH IH M
he	HH IY
should	SH UH D
in	IH N
while	W AY L
was	W AH Z
love	L AH V
broken	B R OW K AH N
were	W ER
his	HH IH S
felt	F EH L T
wife	W AY F
wake	W EY K
if	IH F
shoulder	SH OW L D ER
she	SH IY
only	OW N L IY
millionaires	M IH L Y AH N EH R Z
custody	K AH S T AH D IY
